TILEMAP
20 14							-- Size of tile map in tiles
27 30							-- Tile size & block size
images/balls.png 				-- Tilesheet
2 4 							-- Number of tiles in tilesheet
00000000000000000000
00015678123456780000
00005678123456780000
00025678123456780000
00005678123456780000
00035678123456780000
00005678123456780000
00045678123456780000
00005678123456780000
00015678123456780000
00005678123456780000
00065678123456780000
00005678123456780000
00075678123456780000

